0,0,0,0,0,0,0,0,0,0,0,0,0,0,0,0,0,0,0,0,0,0,0,0,0,0,0,0,0,1,1,1,1,1,1,1,1,1,1,1,1,1,1,1,1,1,1,1,1,1
0,0,0,0,0,0,0,0,0,0,0,0,0,0,0,0,0,0,0,0,0,0,0,0,0,0,0,0,0,1,1,3,7,7,3,7,7,4,7,7,3,7,7,2,7,7,2,7,7,2
0,0,0,0,0,0,0,0,0,0,0,0,0,0,0,0,0,0,0,0,0,0,0,0,0,0,0,0,0,1,1,6,1,1,1,1,1,1,1,1,6,1,1,6,1,1,6,1,1,1
0,0,0,0,0,0,0,0,0,0,0,0,0,0,0,0,0,0,0,0,0,0,0,0,0,0,0,0,0,1,1,6,1,1,1,1,1,1,1,1,6,1,1,6,1,1,6,1,1,1
0,0,0,0,0,0,0,0,0,0,0,0,0,0,0,0,0,0,0,0,0,0,0,0,0,0,0,0,0,1,1,5,1,1,1,1,1,1,1,1,3,1,1,5,1,1,2,1,1,1
0,0,0,0,0,0,0,0,0,0,0,0,0,0,0,0,0,0,0,0,0,0,0,0,0,0,0,0,0,1,1,6,1,1,1,1,1,1,1,1,6,1,1,6,1,1,6,1,1,1
0,0,0,0,0,0,0,0,0,0,0,0,0,0,0,0,0,0,0,0,0,0,0,0,0,0,0,0,1,1,1,6,1,1,1,1,1,1,1,1,6,1,1,6,1,1,6,1,1,1
0,0,0,0,0,0,0,0,0,1,1,1,1,0,0,0,0,0,0,0,0,0,0,0,0,0,0,0,1,1,1,4,1,1,1,1,1,2,7,7,4,1,1,2,7,7,3,1,1,1
0,0,0,0,1,1,1,1,1,1,1,1,1,0,0,0,0,0,0,0,0,0,0,0,0,0,0,0,1,1,1,6,1,1,1,1,1,6,1,1,1,1,1,6,1,1,1,1,1,1
1,1,1,1,1,1,1,1,1,1,1,1,1,1,1,0,0,0,0,0,0,0,0,0,0,0,0,0,1,1,1,6,1,1,1,1,1,6,1,1,1,1,1,6,1,1,1,1,1,1
1,2,7,7,4,7,7,5,7,7,5,7,7,2,1,1,1,0,0,0,0,0,0,0,0,0,0,0,1,1,1,5,1,1,1,1,1,4,1,1,1,1,1,2,1,1,1,1,1,1
1,6,1,1,1,1,1,1,1,1,1,1,1,6,1,1,1,1,1,1,0,0,0,0,0,0,0,1,1,1,1,6,1,1,1,1,1,6,1,1,1,1,1,6,1,1,1,1,1,1
1,6,1,1,1,1,1,1,1,1,1,1,1,6,1,1,1,1,1,1,1,1,1,1,1,1,1,1,1,1,1,6,1,1,1,1,1,6,1,1,1,1,1,6,1,1,1,1,1,1
1,4,1,1,1,1,1,1,1,1,1,1,1,4,7,7,4,7,7,3,7,7,3,7,7,2,7,7,4,7,7,2,7,7,3,7,7,5,1,1,2,7,7,4,1,1,1,1,1,1
1,6,1,1,1,1,1,1,1,1,1,1,1,6,1,1,1,1,1,1,1,1,1,1,1,6,1,1,1,1,1,6,1,1,1,1,1,1,1,1,6,1,1,1,1,1,1,1,1,1
1,6,1,1,1,1,1,1,1,1,1,1,1,6,1,1,1,1,1,1,1,1,1,1,1,6,1,1,1,1,1,6,1,1,1,1,1,1,1,1,6,1,1,1,1,1,1,1,1,1
1,5,1,1,1,1,1,2,7,7,3,7,7,5,7,7,4,7,7,4,1,1,1,1,1,2,7,7,3,7,7,2,1,1,1,1,1,1,1,1,4,1,1,1,1,1,1,1,1,1
1,6,1,1,1,1,1,6,1,1,1,1,1,6,1,1,1,1,1,6,1,1,1,1,1,1,1,1,6,1,1,6,1,1,1,1,1,1,1,1,6,1,1,1,1,1,1,1,1,1
1,6,1,1,1,1,1,6,1,1,1,1,1,6,1,1,1,1,1,6,1,1,1,1,1,1,1,1,6,1,1,6,1,1,1,1,1,1,1,1,6,1,1,1,1,1,1,1,1,1
1,5,1,1,1,1,1,4,1,1,1,1,1,3,1,1,1,1,1,3,1,1,1,1,1,1,1,1,6,1,1,3,1,1,1,1,1,1,1,1,2,7,7,3,7,7,4,7,7,4
1,6,1,1,1,1,1,6,1,1,1,1,1,6,1,1,1,1,1,6,1,1,1,1,1,1,1,1,6,1,1,6,1,1,1,1,1,1,1,1,6,1,1,1,1,1,1,1,1,1
1,6,1,1,1,1,1,6,1,1,1,1,1,6,1,1,1,1,1,6,1,1,1,1,1,1,1,1,6,1,1,6,1,1,1,1,1,1,1,1,6,1,1,1,1,1,1,1,1,1
1,2,7,7,4,7,7,3,7,7,3,7,7,2,1,1,1,1,1,5,7,7,3,7,7,4,7,7,5,7,7,2,7,7,4,7,7,2,7,7,5,1,1,1,1,1,1,1,1,1
1,1,1,1,1,1,1,1,1,1,1,1,1,6,1,1,1,1,1,6,1,1,1,1,1,1,1,1,1,1,1,6,1,1,1,1,1,6,1,1,6,1,1,1,1,1,1,1,1,1
1,1,1,1,1,1,1,1,1,1,1,1,1,6,1,1,1,1,1,6,1,1,1,1,1,1,1,1,1,1,1,6,1,1,1,1,1,6,1,1,6,1,1,1,1,1,1,1,1,1
1,1,1,1,1,1,1,1,1,1,1,1,1,2,7,7,4,7,7,4,1,1,1,1,1,1,1,1,1,1,1,2,7,7,3,7,7,5,7,7,5,7,7,4,7,7,4,7,7,3
1,1,1,1,1,1,1,1,1,1,1,1,1,6,1,1,1,1,1,1,1,1,1,1,1,1,1,1,1,1,1,6,1,1,1,1,1,1,1,1,6,1,1,1,1,1,1,1,1,1
1,1,1,1,1,1,1,1,1,1,1,1,1,6,1,1,1,1,1,1,1,1,1,1,1,1,1,1,1,1,1,6,1,1,1,1,1,1,1,1,6,1,1,1,1,1,1,1,1,1
1,1,1,1,1,1,1,4,7,7,3,7,7,2,1,1,1,1,1,1,1,1,1,1,1,1,1,1,1,1,1,2,1,1,1,1,1,1,1,1,4,1,1,1,1,1,1,1,1,1
1,1,1,1,1,1,1,6,1,1,1,1,1,1,1,1,1,1,1,1,1,1,1,1,1,1,1,1,1,1,1,6,1,1,1,1,1,1,1,1,6,1,1,1,1,1,1,1,1,1
1,1,1,1,1,1,1,6,1,1,1,1,1,1,1,1,1,1,1,1,1,1,1,1,1,1,1,1,1,1,1,6,1,1,1,1,1,1,1,1,6,1,1,1,1,1,1,1,1,1
1,1,1,1,1,1,1,4,1,1,1,1,1,1,1,1,1,1,1,1,1,1,1,1,1,1,1,1,1,1,1,4,1,1,1,1,1,1,1,1,2,1,1,1,1,1,1,1,1,1
1,1,1,1,1,1,1,6,1,1,1,1,1,1,1,1,1,1,1,1,1,1,1,1,1,1,1,1,1,1,1,6,1,1,1,1,1,1,1,1,6,1,1,1,1,1,1,1,1,1
1,1,1,1,1,1,1,6,1,1,1,1,1,1,1,1,1,1,1,1,1,1,1,1,1,1,1,1,1,1,1,6,1,1,1,1,1,1,1,1,6,1,1,1,1,1,1,1,1,1
1,1,1,1,1,1,1,4,1,1,1,1,1,1,1,1,1,1,1,1,1,1,1,1,1,1,1,1,1,1,1,4,1,1,1,1,1,1,1,1,2,1,1,3,7,7,3,7,7,5
1,1,1,1,1,1,1,6,1,1,1,1,1,1,1,1,1,1,1,1,1,1,1,1,1,1,1,1,1,1,1,6,1,1,1,1,1,1,1,1,6,1,1,6,1,1,1,1,1,1
1,1,1,1,1,1,1,6,1,1,1,1,1,1,1,1,1,1,1,1,1,1,1,1,1,1,1,1,1,1,1,6,1,1,1,1,1,1,1,1,6,1,1,6,1,1,1,1,1,1
1,2,7,7,5,7,7,3,1,1,1,1,1,1,1,1,1,1,1,1,1,1,1,1,1,1,1,1,1,1,1,3,7,7,4,7,7,4,7,7,5,1,1,4,1,1,1,1,1,1
1,1,1,1,1,1,1,6,1,1,1,1,1,1,1,1,1,1,1,1,1,1,1,1,1,1,1,1,1,1,1,6,1,1,1,1,1,1,1,1,6,1,1,6,1,1,1,1,1,1
0,0,0,1,1,1,1,6,1,1,1,1,1,1,1,1,1,1,1,1,1,1,1,1,1,1,1,1,1,1,1,6,1,1,1,1,1,1,1,1,6,1,1,6,1,1,1,1,1,1
0,0,0,0,0,1,1,2,7,7,2,1,1,1,1,1,1,1,1,3,7,7,5,7,7,2,7,7,4,7,7,2,1,1,1,1,1,1,1,1,3,1,1,4,1,1,1,1,1,1
0,0,0,0,0,0,1,1,1,1,6,1,1,1,1,1,1,1,1,6,1,1,1,1,1,1,1,1,1,1,1,1,1,1,1,1,1,1,1,1,6,1,1,6,1,1,1,1,1,1
0,0,0,0,0,0,0,0,1,1,6,1,1,1,1,1,1,1,1,6,1,1,1,1,1,1,1,1,0,0,0,0,0,1,1,1,1,1,1,1,6,1,1,6,1,1,1,1,1,1
0,0,0,0,0,0,0,0,0,1,2,7,7,5,7,7,3,7,7,2,1,1,1,0,0,0,0,0,0,0,0,0,0,0,0,0,1,1,1,1,3,1,1,4,1,1,1,1,1,1
0,0,0,0,0,0,0,0,0,1,1,1,1,6,1,1,6,1,1,1,1,0,0,0,0,0,0,0,0,0,0,0,0,0,0,0,0,0,1,1,6,1,1,6,1,1,1,1,1,1
0,0,0,0,0,0,0,0,0,0,0,1,1,6,1,1,6,1,1,1,0,0,0,0,0,0,0,0,0,0,0,0,0,0,0,0,0,0,1,1,6,1,1,6,1,1,1,1,1,1
0,0,0,0,0,0,0,0,0,0,0,1,1,2,7,7,4,1,1,0,0,0,0,0,0,0,0,0,0,0,0,0,0,0,0,0,0,0,0,1,2,7,7,2,1,1,1,1,1,1
0,0,0,0,0,0,0,0,0,0,0,0,1,1,1,1,1,1,0,0,0,0,0,0,0,0,0,0,0,0,0,0,0,0,0,0,0,0,0,1,1,1,1,6,1,1,1,1,1,1
0,0,0,0,0,0,0,0,0,0,0,0,0,0,1,1,0,0,0,0,0,0,0,0,0,0,0,0,0,0,0,0,0,0,0,0,0,0,0,0,1,1,1,6,1,1,1,1,1,1
0,0,0,0,0,0,0,0,0,0,0,0,0,0,0,0,0,0,0,0,0,0,0,0,0,0,0,0,0,0,0,0,0,0,0,0,0,0,0,0,1,1,1,2,7,7,3,7,7,3
